5 5 5 5 5 5 5 5 5 5 5 8 5 5 5 5 5 5 5 5 5 5 5 5 5
5 7 4 4 4 4 4 4 4 4 4 4 4 4 4 4 4 4 4 4 4 4 4 4 5
5 7 4 7 7 7 7 7 7 7 7 7 7 7 7 7 7 7 7 7 7 7 7 4 5
5 7 4 4 4 4 4 4 4 4 4 2 4 4 4 4 4 4 4 4 4 4 4 4 5
5 7 7 7 2 7 7 7 7 7 4 2 4 7 7 7 7 7 7 7 7 7 7 7 5
5 7 7 2 1 2 7 7 7 7 4 1 4 7 7 7 7 7 7 7 7 7 7 7 5
5 7 7 7 2 7 7 7 7 7 4 2 4 7 7 7 7 7 7 7 7 7 7 7 5
5 7 7 3 3 3 3 3 3 3 3 2 3 3 3 3 3 3 3 3 3 3 7 7 5
5 7 7 3 7 7 7 5 5 5 5 5 5 5 5 5 7 7 7 7 7 3 7 7 5
5 7 7 3 7 0 0 5 2 2 2 2 2 2 2 5 7 7 0 0 7 3 7 7 5
5 7 7 3 7 0 0 5 2 2 2 2 2 2 2 5 7 7 0 0 7 3 7 7 5
5 7 7 3 7 7 7 5 5 5 4 9 4 5 5 5 7 7 7 7 7 3 7 7 5
5 7 7 3 7 7 4 4 4 4 4 0 4 4 4 4 7 7 7 7 7 3 7 7 5
5 7 7 3 7 7 4 5 5 5 5 5 5 5 5 4 7 7 7 7 7 3 7 7 5
5 7 7 3 7 7 4 5 7 7 7 7 7 7 5 4 7 7 0 0 7 3 7 7 5
5 7 7 3 7 7 4 5 5 5 3 3 5 5 5 4 7 7 0 0 7 3 7 7 5
5 7 7 3 7 7 4 4 4 3 2 2 3 4 4 4 7 7 7 7 7 3 7 7 5
5 7 7 3 3 3 7 7 7 3 2 2 3 7 7 7 7 7 3 3 3 3 7 7 5
5 7 7 7 7 3 7 7 7 3 2 2 3 7 7 7 2 7 3 7 7 7 7 7 5
5 6 6 6 7 3 7 7 7 3 2 2 3 7 7 2 1 2 3 7 7 7 7 7 5
5 6 6 6 7 3 7 7 7 3 2 2 3 7 7 7 2 7 3 7 3 3 3 3 5
5 2 2 2 2 3 7 7 7 3 2 2 3 7 7 7 7 7 3 7 3 2 2 2 5
5 2 3 3 2 3 3 3 3 3 2 2 3 3 3 3 3 3 3 7 3 2 1 2 5
5 2 3 3 2 7 7 7 7 7 7 7 7 7 7 7 7 7 7 7 3 2 2 2 5
5 5 5 5 5 5 5 5 5 5 5 5 5 5 5 5 5 5 5 5 5 5 5 5 5
