5 5 5 5 5 5 5 5 5 5 5 5 5 5 5 5 5 5 5 5 5 5 5 5 5
5 3 3 3 3 3 3 3 3 3 3 3 3 3 3 3 3 3 3 3 3 3 3 3 5
5 3 7 7 7 7 7 7 7 7 7 7 7 7 7 7 7 7 7 7 7 7 7 3 5
5 3 7 7 7 7 7 7 7 7 7 7 7 7 7 7 7 7 7 7 7 7 7 3 5
5 3 3 3 3 3 3 3 3 3 3 3 3 3 3 3 3 3 3 3 3 3 7 3 5
5 5 5 5 5 5 5 5 5 5 5 5 5 5 5 5 5 5 5 5 5 3 7 3 5
5 3 3 3 3 3 3 3 3 3 3 3 3 3 3 3 3 3 3 3 5 3 7 3 5
5 3 7 7 7 7 7 7 7 7 7 7 7 7 7 7 7 7 7 3 5 3 7 3 5
5 3 7 3 3 3 3 3 3 3 3 3 3 3 3 3 3 3 7 3 5 3 7 3 5
5 3 7 3 7 7 7 7 7 7 7 7 7 7 7 7 7 3 7 3 5 3 7 3 5
5 3 7 3 7 3 3 3 3 3 3 3 3 3 3 3 7 3 7 3 5 3 7 3 5
5 3 7 3 7 3 5 5 5 5 5 5 5 5 5 3 7 3 7 3 5 3 7 3 8
5 3 7 3 7 3 5 3 3 3 3 3 3 3 5 3 7 3 7 3 5 3 7 1 5
5 3 7 3 7 3 5 3 2 2 2 2 2 3 5 3 7 3 7 3 5 3 7 1 5
5 3 7 3 7 3 5 3 2 2 3 9 2 3 5 3 7 3 7 3 5 3 7 1 5
5 3 7 3 7 3 5 3 2 2 3 3 3 3 5 3 7 3 7 3 5 3 7 1 5
5 3 7 3 7 3 5 3 2 2 2 2 2 2 5 3 7 3 7 3 5 3 7 1 5
5 3 7 3 7 3 5 3 3 3 3 3 3 3 3 3 7 3 7 3 5 3 7 1 5
5 3 7 3 7 3 7 7 7 7 7 7 7 7 7 7 7 3 7 3 5 3 7 1 5
5 3 7 3 7 3 3 3 3 3 3 3 3 3 3 3 3 3 7 3 5 3 7 1 5
5 3 7 3 7 7 7 7 7 7 7 7 7 7 7 7 7 7 7 3 5 3 7 1 5
5 3 7 3 3 3 3 3 3 3 3 3 3 3 3 3 3 3 3 3 5 3 7 1 5
5 3 7 7 7 7 7 7 7 7 7 7 7 7 7 7 7 7 7 7 5 3 7 1 5
5 3 3 3 3 3 3 3 3 3 3 3 3 3 3 3 3 3 3 3 3 3 7 1 5
5 5 5 5 5 5 5 5 5 5 5 5 5 5 5 5 5 5 5 5 5 5 5 5 5
